"Dr. No"	"Sean Connery"
"Thunderball"	"Sean Connery"
"Octopussy"	"Roger Moore"
"GoldenEye"	"Pierce Brosnan"
"Never Say Never Again"	"Sean Connery"
"From Russia With Love"	"Sean Connery"
"Goldfinger"	"Sean Connery"
"You Only Live Twice"	"Sean Connery"
"On Her Majesty's Secret Service"	"George Lazenby"
"Diamonds are Forever"	"Sean Connery"
"Live and Let Die"	"Roger Moore"
"Man With the Golden Gun"	"Roger Moore"
"The Spy Who Loved Me"	"Roger Moore"
"Moonraker"	"Roger Moore"
"For You Eyes Only"	"Roger Moore"
"A View to a Kill"	"Roger Moore"
"The Living Daylights"	"Timothy Dalton"
"Licence to Kill"	"Timothy Dalton"
"Tomorrow Never Dies"	"Pierce Brosnan"
"The World is Not Enough"	"Pierce Brosnan"
